111111111111111
100001C100000P1
100001110000001
1E000000010C001
111111111111111
