1111111111111111111111111111111
10000000000000E0000000000000011
100C0000000000000000C0000000111
100C0000000000000000C0000000111
100C0000000000000000C0000000111
1000000000000000000000000000111
100C001111000000011100C00001111
100C0010000000000000100C0010111
10000010000000P0000100000101111
1000001000000000000100000101111
100C001000000000000100C00101111
100C001000000000000100C00101111
1000001111000000011100000111111
1000000000000000000000000000111
100C0000000000000000C0000000111
100C0000000000000000C0000000111
100C0000000000000000C0000000111
1000001111111111111111111111111
1111111111111111111111111111111
