111111111111111
10000C0000000P1
1E00N000000C001
111111111111111