111111111111111
100001C10000001
1000011100P0001
1E000000010C001
111111111111111
