111111111111111
1000000000000P1
1E00N000000C001
111111111111111