111111111111111
100001C00000001
10000111000P001
1E0000000100001
111111111111111
