1111111111111111111111111111111
1000000000000000000000000000011
100C000000E000000000C0000000111
100C0000000000000000C0000000111
100C0000000000000000C0000000111
1000000000000000000000000000001
100C001111000000011100C00001001
100C0010000000000000100C0010011
100000100000000P000100000100001
1000001000000000000100000100001
100C001000000000000100C00101111
100C001000000000000100C00101111
1000001111000000011100000111111
1000000000000000000000000000111
100C0000000000000000C0000000111
100C0000000000000000C0000000111
100C0000000000000000C0000000111
1111111111111111111111111111111
