111111111
1C00E0P01
100000001
111111111
