111111111
1C00E0P01
111111111
